11111111111111111111111111111111111111111
10000000000000000000000000000000000000001
1C00C000000000000000C00000000000000000001
10000000000000000000000000000000000000001
10000000000000000000000000000000000000001
1P000000000000000000000000000000000000001
1P000000000000000000000000000000000000E01
1P000000000000000000000000000000000000001
1P000000000000000000000000000000000000001
1P000000000000000000000000000000000000001
1P000000000000000000000000000000000000001
11111111111111111111111111111111111111111
